020401860
034002057
000050040
905008720
000109000
048500306
080030000
450200930
092704010