000300762
035082090
060400583
004500807
000000000
207008600
621007050
070190240
943006000