060000300
400863070
200070060
040005003
002000600
600300010
070030002
050729006
003000080