010009000
003000106
090081070
009240010
800000005
030016900
050190020
907000500
000500080