000580307
057230091
603070000
000002054
015407280
260100000
000020409
540013860
102049000